36316 / 1355
v            
.#.#####.#.##
...#.#.#....#
.#....#..#.#.
..##.#.#.#...
.##..#....#.#
...#.....#...
...#.#.##.#.#
.#..#.#.##..#
...#......#..
###.#.##.##.#
....#.#......
.#.....#.##.#
.#.#.##...###
^            